participant_id	Sex	Age	Go Accuracy	NoGo Accuracy	TS	PSS	EPDS	MH Simple Sum	Neglect	Cold	Abuse	Isolation	Violence	Conflict	Depression	Econ	Community	CPAS Simple Sum
sub-01	1	73	93.33	85	43	27	11	81	4	6	15	10	8	13	16	6	4	82
sub-02	1	73	96.11	95	36	6	3	45	2	1	9	4	1	2	11	4	3	37
sub-03	1	73	81.11	75	45	18	6	69	4	10	16	10	7	10	16	11	10	94
sub-04	1	73	97.22	80	45	1	0	46	5	9	16	6	6	9	8	2	10	71
sub-05	1	73	92.78	88.33	40	23	6	69	2	5	5	1	3	7	6	2	2	33
sub-06	1	74	98.89	83.33	50	29	8	87	11	10	13	8	0	2	7	8	0	59
sub-07	1	74	97.22	78.33	28	3	2	33	0	4	7	0	0	5	0	0	0	16
sub-08	1	81	86.67	80	35	5	1	41	1	0	5	0	0	3	4	1	2	16
sub-09	2	81	85.56	73.33	32	5	0	37	2	5	3	5	1	9	4	0	0	29
sub-10	1	80	93.89	93.33	46	12	5	63	2	5	8	1	0	5	8	1	2	32
sub-11	2	81	92.22	51.67	26	2	0	28	4	2	19	2	0	1	6	2	0	36
sub-12	2	81	89.44	96.67	29	13	1	43	2	7	8	2	1	3	4	1	0	28
sub-13	2	79	88.89	91.67	28	5	2	35	2	2	1	0	0	3	0	1	5	14
sub-14	1	72	95	85	41	4	0	45	0	2	11	0	0	0	5	1	0	19
sub-15	2	84	91.11	83.33	71	17	9	97	4	1	16	0	0	5	10	16	0	52
sub-16	1	84	85	58.33	25	5	0	30	0	0	2	0	0	2	0	0	0	4
sub-17	2	84	93.89	83.33	29	14	2	45	0	7	22	5	2	5	0	1	3	45
sub-18	1	83	99.44	95	55	18	2	75	12	6	11	8	2	10	13	16	18	96
sub-19	1	81	95	91.67	33	21	8	62	0	0	14	9	2	5	14	1	2	47
sub-20	2	82	76.11	76.67	26	4	0	30	2	4	6	6	3	10	10	2	1	44
sub-21	1	80	95	73.33	42	34	15	91	0	3	6	11	2	10	18	8	0	58
sub-22	2	84	90	85	33	7	2	42	0	7	6	0	0	3	2	2	0	20
sub-23	1	70	85.56	83.33	36	24	6	66	1	5	18	1	0	4	6	5	1	41
sub-24	2	83	83.33	96.67	25	5	0	30	1	0	7	0	0	1	1	3	0	13
sub-25	1	83	100	100	48	14	12	74	9	1	15	15	11	10	10	10	6	87
sub-26	1	80	93.89	80	28	10	0	38	0	2	20	2	1	4	2	0	4	35
sub-27	2	82	93.89	86.67	37	6	0	43	0	0	10	4	0	1	10	2	1	28
sub-28	2	81	92.22	63.33	25	3	0	28	1	3	11	0	0	5	8	0	8	36
sub-29	2	83	91.67	91.67	46	22	7	75	0	1	11	5	0	9	11	9	10	56
sub-30	1	83	90	53.33	29	17	4	50	0	2	15	5	3	6	7	4	13	55
sub-31	2	83	87.78	81.67	42	11	6	59	0	0	12	2	0	3	2	2	4	25
sub-32	2	80	98.33	95	25	9	4	38	2	0	17	3	0	2	6	0	1	31
sub-33	2	83	90	91.67	29	20	5	54	0	1	11	10	0	8	12	5	6	53
sub-34	1	84	94.44	85	26	11	7	44	3	5	8	0	0	5	0	1	1	23
sub-35	1	83	91.67	95	30	4	0	34	2	4	3	0	0	4	0	0	0	13
sub-36	2	83	86.67	93.33	34	13	0	47	0	7	7	6	6	8	14	2	4	54
sub-37	2	83	88.89	88.33	25	4	0	29	0	4	2	0	0	1	0	0	0	7
sub-38	1	82	92.22	85	26	4	1	31	2	1	16	2	0	3	3	0	0	27
sub-39	2	84	93.89	93.33	26	9	0	35	0	7	8	1	0	9	0	0	0	25
sub-40	1	83	98.33	56.67	37	8	2	47	0	1	19	4	0	5	6	4	0	39
sub-41	1	83	97.78	91.67	37	0	0	37	0	4	5	1	0	5	3	1	0	19
sub-42	1	84	97.22	93.33	29	14	0	43	2	5	11	10	0	10	12	2	2	54
sub-43	1	84	97.22	88.33	48	6	0	54	5	2	11	4	0	5	9	6	2	44
sub-44	1	84	95	75	32	25	6	63	4	7	11	10	5	12	10	10	2	71
sub-45	2	83	87.78	88.33	47	13	1	61	2	4	18	5	3	9	6	4	3	54
sub-46	1	83	95	76.67	25	7	0	32	3	5	8	6	7	13	12	2	1	57
sub-47	2	69	88.89	88.33	40	13	1	54	0	0	9	2	0	5	12	9	0	37
sub-48	1	83	86.11	68.33	58	21	12	91	2	6	13	0	0	6	6	2	2	37
sub-49	2	83	80.56	78.33	28	22	6	56	3	5	12	10	3	13	13	7	4	70
sub-50	2	83	82.78	71.67	42	9	7	58	3	3	14	5	0	7	8	0	2	42
sub-51	2	83	95	90	27	9	5	41	4	3	0	3	0	3	19	8	0	40
sub-52	1	84	84.44	61.67	33	13	3	49	4	2	16	2	0	5	8	1	0	38
sub-53	2	83	74.44	80	25	5	0	30	3	8	8	1	0	3	6	0	1	30
sub-54	2	83	77.78	85	31	30	10	71	4	2	22	20	0	17	24	0	0	89
sub-55	2	83	91.67	96.67	32	26	6	64	0	8	10	0	0	1	0	1	0	20
sub-56	2	83	89.44	93.33	38	2	0	40	0	1	19	6	8	10	18	4	8	74
sub-57	1	83	77.78	70	37	14	1	52	0	7	0	0	2	2	0	0	2	13
sub-58	1	83	99.44	93.33	48	13	0	61	0	3	5	6	0	8	10	5	0	37
sub-59	2	75	80	96.67	36	22	6	64	3	5	11	1	0	1	12	2	6	41
sub-60	2	84	85.56	85	33	2	0	35	12	0	23	10	0	13	19	17	4	98
sub-61	1	67	86.11	51.67	28	13	0	41	0	0	11	0	0	3	1	0	0	15
sub-62	1	66	75.56	91.67	26	9	0	35	0	2	8	0	0	4	3	0	0	17
sub-63	2	63	72.22	88.33	25	8	0	33	0	4	8	0	0	3	1	0	0	16
sub-64	1	63	85.56	86.67	29	11	0	40	0	0	9	0	0	4	2	0	0	15
sub-65	2	66	84.44	71.67	30	6	0	36	0	1	7	0	0	1	0	0	0	9
sub-66	2	61	97.78	96.67	30	9	0	39	0	1	7	0	0	4	5	2	0	19
sub-67	2	70	75	95	26	16	3	45	0	0	6	8	3	9	3	2	0	31
sub-68	2	66	89.44	100	29	7	0	36	0	1	7	0	0	5	3	0	0	16